Stachel	lowA_lowS
Krabbe	lowA_lowS
Gefieder	lowA_lowS
Pfeiler	lowA_lowS
Gehöft	lowA_lowS
Knospe	lowA_lowS
Zipfel	lowA_lowS
Lagune	lowA_lowS
Prärie	lowA_lowS
Gebirge	lowA_lowS
Veranda	lowA_lowS
Grabmal	lowA_lowS
Schlund	lowA_lowS
Vordach	lowA_lowS
Zisterne	lowA_lowS
Tunnel	lowA_lowS
Schlamm	lowA_lowS
Qualle	lowA_lowS
Kuppel	lowA_lowS
Schleim	lowA_lowS
Fenchel	lowA_lowS
Sockel	lowA_lowS
Akazie	lowA_lowS
Emblem	lowA_lowS
Sensor	lowA_lowS
Koralle	lowA_lowS
Kiesel	lowA_lowS
Zapfen	lowA_lowS
Kruste	lowA_lowS
Krater	lowA_lowS
Bildnis	lowA_lowS
Korridor	lowA_lowS
Graben	lowA_lowS
Piranha	lowA_lowS
Oktopus	lowA_lowS
Mumie	lowA_lowS
Seestern	lowA_lowS
Gecko	lowA_lowS
Dunst	lowA_lowS
Minze	lowA_lowS
Rinne	lowA_lowS
Palast	lowA_lowS
Moor	lowA_lowS
Sumpf	lowA_lowS
Knolle	lowA_lowS
Fels	lowA_lowS
Asche	lowA_lowS
Steinweg	lowA_lowS
Eiche	lowA_lowS
Wolke	lowA_lowS
Statue	lowA_lowS
Sandbank	lowA_lowS
Düne	lowA_lowS
Quartier	lowA_lowS
Borke	lowA_lowS
Tentakel	lowA_lowS
Rebstock	lowA_lowS
Lamm	lowA_lowS
Skorpion	lowA_lowS
Erdhügel	lowA_lowS
Eidechse	lowA_lowS
Satellit	lowA_lowS
Zimmer	lowA_lowS
Scheinwerfer	lowA_lowS
Schatzkammer	lowA_lowS
Schutzhütte	lowA_lowS
Felsgestein	lowA_lowS
Rückleuchte	lowA_lowS
Miesmuschel	lowA_lowS
Kaulquappe	lowA_lowS
Fliegenpilz	lowA_lowS
Blütenstaub	lowA_lowS
Einhorn	lowA_lowS
Schweif	lowA_lowS
Mahnmal	lowA_lowS
Molekül	lowA_lowS
Thymian	lowA_lowS
Pfosten	lowA_lowS
Asphalt	lowA_lowS
Marmor	lowA_lowS
Verdeck	lowA_lowS
Vorhof	lowA_lowS
Flecken	lowA_lowS
Porträt	lowA_lowS
Falter	lowA_lowS
Abhang	lowA_lowS
Zement	lowA_lowS
Kristall	lowA_lowS
Pollen	lowA_lowS
Pappel	lowA_lowS
Sphinx	lowA_lowS
Gitter	lowA_lowS
Schilf	lowA_lowS
Schwefel	lowA_lowS
Lavendel	lowA_lowS
Staude	lowA_lowS
Schuppe	lowA_lowS
Kastanie	lowA_lowS
Natter	lowA_lowS
Giraffe	lowA_lowS
Pulver	lowA_lowS
Planet	lowA_lowS
Flagge	lowA_lowS
Ziegel	lowA_lowS
Flocke	lowA_lowS
Diagramm	lowA_lowS
Visier	lowA_lowS
Aufdruck	lowA_lowS
Schnecke	lowA_lowS
Papagei	lowA_highS
Jaguar	lowA_highS
Tonband	lowA_highS
Kakadu	lowA_highS
Brandung	lowA_highS
Saloon	lowA_highS
Tornado	lowA_highS
Elefant	lowA_highS
Panther	lowA_highS
Gorilla	lowA_highS
Büffel	lowA_highS
Zirkus	lowA_highS
Truthahn	lowA_highS
Ferkel	lowA_highS
Sirene	lowA_highS
Wasserwerk	lowA_highS
Kapelle	lowA_highS
Gondel	lowA_highS
Flugplatz	lowA_highS
Specht	lowA_highS
Propeller	lowA_highS
Auspuff	lowA_highS
Spatz	lowA_highS
Staudamm	lowA_highS
Grille	lowA_highS
Flieger	lowA_highS
Henne	lowA_highS
Geläut	lowA_highS
Pavian	lowA_highS
Hyäne	lowA_highS
Kolibri	lowA_highS
Kröte	lowA_highS
Theater	lowA_highS
Trafo	lowA_highS
Stadion	lowA_highS
Getriebe	lowA_highS
Düsenjet	lowA_highS
Elch	lowA_highS
Krähe	lowA_highS
Tiger	lowA_highS
Triebwerk	lowA_highS
Fluss	lowA_highS
Stier	lowA_highS
Panda	lowA_highS
Turbine	lowA_highS
Lawine	lowA_highS
Taube	lowA_highS
Straße	lowA_highS
Kuckuck	lowA_highS
Ziege	lowA_highS
Motor	lowA_highS
Hummel	lowA_highS
Küken	lowA_highS
Amsel	lowA_highS
Flughafen	lowA_highS
Wasserfall	lowA_highS
Tiergarten	lowA_highS
Affe	lowA_highS
Uhu	lowA_highS
Esel	lowA_highS
Ente	lowA_highS
Schimpanse	lowA_highS
Kondensator	lowA_highS
Eule	lowA_highS
Aula	lowA_highS
Feuersturm	lowA_highS
Rabe	lowA_highS
Wal	lowA_highS
Nachtlokal	lowA_highS
Transistor	lowA_highS
Möwe	lowA_highS
Park	lowA_highS
Hamster	lowA_highS
Sperling	lowA_highS
Marder	lowA_highS
Schwan	lowA_highS
Lüftung	lowA_highS
Gebläse	lowA_highS
Flugzeug	lowA_highS
Schwalbe	lowA_highS
Frosch	lowA_highS
Meise	lowA_highS
Drossel	lowA_highS
Rotor	lowA_highS
Zaunkönig	lowA_highS
Dohle	lowA_highS
Schaf	lowA_highS
Singvogel	lowA_highS
Helikopter	lowA_highS
Schminke	highA_lowS
Kommode	highA_lowS
Tablette	highA_lowS
Bikini	highA_lowS
Strumpf	highA_lowS
Paprika	highA_lowS
Bargeld	highA_lowS
Schraube	highA_lowS
Skizze	highA_lowS
Frisbee	highA_lowS
Zwiebel	highA_lowS
Korsett	highA_lowS
Umschlag	highA_lowS
Zeichnung	highA_lowS
Scharnier	highA_lowS
Schleppe	highA_lowS
Schlitten	highA_lowS
Saatgut	highA_lowS
Stativ	highA_lowS
Schemel	highA_lowS
Banane	highA_lowS
Tupfer	highA_lowS
Prothese	highA_lowS
Krücke	highA_lowS
Lineal	highA_lowS
Karabiner	highA_lowS
Joghurt	highA_lowS
Sattel	highA_lowS
Skalpell	highA_lowS
Sichel	highA_lowS
Knauf	highA_lowS
Einrad	highA_lowS
Ausweis	highA_lowS
Kordel	highA_lowS
Toast	highA_lowS
Paddel	highA_lowS
Knopf	highA_lowS
Zügel	highA_lowS
Bumerang	highA_lowS
Anker	highA_lowS
Kartoffel	highA_lowS
Ranzen	highA_lowS
Waage	highA_lowS
Spind	highA_lowS
Regal	highA_lowS
Webstuhl	highA_lowS
Mappe	highA_lowS
Butter	highA_lowS
Wickel	highA_lowS
Haken	highA_lowS
Lasche	highA_lowS
Degen	highA_lowS
Textilie	highA_lowS
Hacke	highA_lowS
Matte	highA_lowS
Himbeere	highA_lowS
Rollstuhl	highA_lowS
Spaghetti	highA_lowS
Gurt	highA_lowS
Kamm	highA_lowS
Kajak	highA_lowS
Paket	highA_lowS
Lupe	highA_lowS
Flyer	highA_lowS
Wiege	highA_lowS
Atlas	highA_lowS
Jeans	highA_lowS
Brot	highA_lowS
Zahnspange	highA_lowS
Mikroskop	highA_lowS
Folie	highA_lowS
Herd	highA_lowS
Zahnrad	highA_lowS
Krümel	highA_lowS
Schlinge	highA_lowS
Kandare	highA_lowS
Diskette	highA_lowS
Futter	highA_lowS
Schlaufe	highA_lowS
Peperoni	highA_lowS
Krokette	highA_lowS
Tabak	highA_lowS
Filet	highA_lowS
Tandem	highA_lowS
Scheck	highA_lowS
Magnet	highA_lowS
Moped	highA_highS
Flöte	highA_highS
Drucker	highA_highS
Triangel	highA_highS
Lasso	highA_highS
Trommel	highA_highS
Peitsche	highA_highS
Roller	highA_highS
Schleuder	highA_highS
Knarre	highA_highS
Stapler	highA_highS
Geschütz	highA_highS
Bombe	highA_highS
Flinte	highA_highS
Seilzug	highA_highS
Schleifer	highA_highS
Festwagen	highA_highS
Rekorder	highA_highS
Harfe	highA_highS
Mixer	highA_highS
Walze	highA_highS
Hammer	highA_highS
Dusche	highA_highS
Gitarre	highA_highS
Cello	highA_highS
Bohrer	highA_highS
Karussell	highA_highS
Telefon	highA_highS
Geige	highA_highS
Klavier	highA_highS
Posaune	highA_highS
Saite	highA_highS
Hobel	highA_highS
Dynamit	highA_highS
Trompete	highA_highS
Pistole	highA_highS
Säugling	highA_highS
Fagott	highA_highS
Böller	highA_highS
Saxophon	highA_highS
Akkordeon	highA_highS
Keyboard	highA_highS
Pferd	highA_highS
Motorrad	highA_highS
Tastatur	highA_highS
Computer	highA_highS
Baby	highA_highS
Alphorn	highA_highS
Rassel	highA_highS
Tamburin	highA_highS
Zapfhahn	highA_highS
Kind	highA_highS
Meißel	highA_highS
Hebebühne	highA_highS
Dudelsack	highA_highS
Xylophon	highA_highS
Kran	highA_highS
Banjo	highA_highS
Tuba	highA_highS
Schlagzeug	highA_highS
Lagerfeuer	highA_highS
Mäher	highA_highS
Hupe	highA_highS
Auto	highA_highS
Kontrabass	highA_highS
Klarinette	highA_highS
Blasebalg	highA_highS
Taktstock	highA_highS
Kettensäge	highA_highS
Dampfwalze	highA_highS
Blockflöte	highA_highS
Motorsäge	highA_highS
Wischer	highA_highS
Granate	highA_highS
Blinker	highA_highS
Klöppel	highA_highS
Schalter	highA_highS
Schaukel	highA_highS
Rakete	highA_highS
Kanone	highA_highS
Gewehr	highA_highS
Mörser	highA_highS
Revolver	highA_highS
Pfeife	highA_highS
Blech	highA_highS
Wippe	highA_highS
Klaviatur	highA_highS
Mikrofon	highA_highS
